  __   _       _  __  ___
 (_ ` / ) / / /_) )_) )_  
.__) (_X (_/ / / / \ (__  
                          
 __       __      ___ __  
 )_) / / (_ ` )_) )_  )_) 
/   (_/ .__) ( ( (__ / \  
                          
