 _____  _____ _   _  ___  ______ ___________ _   _ _____ _   _  ___________ 
/  ___||  _  | | | |/ _ \ | ___ \  ___| ___ \ | | /  ___| | | ||  ___| ___ \
\ `--. | | | | | | / /_\ \| |_/ / |__ | |_/ / | | \ `--.| |_| || |__ | |_/ /
 `--. \| | | | | | |  _  ||    /|  __||  __/| | | |`--. \  _  ||  __||    / 
/\__/ /\ \'/ / |_| | | | || |\ \| |___| |   | |_| /\__/ / | | || |___| |\ \ 
\____/  \_/\_\\___/\_| |_/\_| \_\____/\_|    \___/\____/\_| |_/\____/\_| \_|
