            .==.            
         =+- == -+=         
     :+=.    ==    .=+:     
   +-        ==        -+   
   *. ::     ==     :: .*   
   +.    :-. == .-:    .+   
   =:       :-=:       .=   
   -:     =*.:-.*=     .-   
   -: .==.   :-   .==. :-   
   :*+       ::       +*:   
     -+:     ::     .+-     
        *+   ::   =*.       
          .+=--=+.          
             --             