           =:               
        .+:*  .-++=.        
      :+:  *        .-++.   
    =*     *         .:-:   
   +=-.    *        :  =.   
   +:    -+=.     -    =.   
   =:      *- ::=.     z=    
   --    :*   -#*.     =    
   :-  :*.      +  :-+-=    
   := *.        +     *.    
   .#+          +   --      
      .+*+.     + .+        
           .=*+:+=:         
                :           