                            
       .*=  .-=+++++=-.     
      .+ =           .+     
     :+  =           =+     
    -+   =          =.+     
    +. -+**+-:     =: +     
    =:   =       .-* .+     
    =-   -  -*##*+=* .+     
    == :=         :* :.     
    =+.=          :* -      
    -*=           :+-       
    :**+-.        -*:       
           .:-=+*+**        
                            