                            
      :+============+:      
      -=            --      
      +=            =+      
      *+            +*      
      =-::::::::::::-=      
      *+            +*      
      **############**      
      #=            =#      
      #-            -#      
      *:            :*      
      +:            .+      
      .::::::::::::::.      
                            