                            
     .:=+++++=-.  =*.       
     +:           = +:      
     +=.          =  +-     
     +.=          =   +-    
     + :=     .-+**+-. +    
     +. #-.       -   .+    
     =. #=+*##*=  -.  :+    
     .: #:         -: ==    
      - *:          -:+=    
       -+-           =*=    
       :*-        .-+**:    
        **+*+=-:.           
                            