              :=           
        .=++-.  *:+.        
   .++-:        *  :+-      
   :-::         *     *=    
   .=  :.       *    .-=+   
   .=    -     .=+-    .+   
    =     .=:: -*      :=   
    =     .*#-   *:    :-   
    =-+-:  +       +:  -:   
     +     +        .* =:   
      -=   +          +#.   
        +: +     .+*+.      
         :=+:+*=.           
           :                